000000000000
000000000000
000000000000
000000000000
000144444000
000040024000
000040044000
000044444000
000040040000
000040040000
000044444430
000000000000