000004400000
000001444440
000044400440
433040400400
444442440200
044040444400
000044400200
000000000440
000034444440
000000000000
000000000000
000000000000