000000000000
000000000000
000000003000
000144424000
000004444000
000000000000
000000000000
000000000000
000000000000
000000000000
000000000000
000000000000
